                                    
                       /------------
                   /---    ----\   |
               +----+  ---/     \  |
           /---|    | \    A /---- |
       /---    | WC |  ------      |
   /---        +----+              |
---                                 
--                         F        
  \---                              
      \--                   ----\  |
         \---           ---/     \ |
             \---      \    B /----|
                 \--    ------     |
                    \---           |
                        \-----------