                                                                      -                  /                       
                                                                    -/                  |                        
                                                                   /                    /                        
                                                                 -/                    /                         
                                                               -/                     /                          
                                                              /                      |                           
                                                            -/       EMERG EXIT      /                           
                                                           /         +--------+     |                            
                       /---------------------------------------------+--------+---------------------------       
                   /---    ----\   |   +--+  +--+  +--+  +--+ |F +--+ +--+ +--+ +--+ +--+ +--+ +--+ +--+ +------+
               +----+  ---/     \  | F |  |  |  |  |  |  |  | |  +--+ +--+ +--+ +--+ +--+ +--+ +--+ +--+ |  WC  |
           /---|    | \    A /---- |   +--+  +--+  +--+  +--+ |E |  | |  | |  | |  | |  | |  | |  | |  | +------+
       /---    | WC |  ------      | E |  |  |  |  |  |  |  | |  +--+ +--+ +--+ +--+ +--+ +--+ +--+ +--+         
   /---        +----+              |   +--+  +--+  +--+  +--+ |D |  | |  | |  | |  | |  | |  | |  | |  |         
---                                                              +--+ +--+ +--+ +--+ +--+ +--+ +--+ +--+         
--                         F            1     2     3     4       5    6    7    8    9    10   11   12          
  \---                                                           +--+ +--+ +--+ +--+ +--+ +--+ +--+ +--+         
      \--                   ----\  |   +--+  +--+  +--+  +--+ |C |  | |  | |  | |  | |  | |  | |  | |  |         
         \---           ---/     \ | B |  |  |  |  |  |  |  | |  +--+ +--+ +--+ +--+ +--+ +--+ +--+ +--+         
             \---      \    B /----|   +--+  +--+  +--+  +--+ |B |  | |  | |  | |  | |  | |  | |  | |  |         
                 \--    ------     | A |  |  |  |  |  |  |  | |  +--+ +--+ +--+ +--+ +--+ +--+ +--+ +--+         
                    \---           |   +--+  +--+  +--+  +--+ |A +--+ +--+ +--+ +--+ +--+ +--+ +--+ +--+         
                        \--------------------------------------------+--------+----------------------------      
                                                        \            +--------+   |                              
                                                         -\          EMERG EXIT    \                             
                                                           \                       |                             
                                                            -\                      \                            
                                                              \                      \                           
                                                               \                     |                           
                                                                -\                    \                          
                                                                  -                                              